############################################################
    ######       #######   ################    #############
### ###### ##### ####### # #################################
### #      ##### #######  ##################################
### ############ ####################################### ###
###                                    ################# ###
### ##################################        ########## ###
### #          ####################### ###### ########## ###
### ########## ####################### ###### ##############
### ##########                                ##############
### ###          ######################## ##################
### ########## ########################## ##################
###            ########################## ##################
### ########## ##########     ###########   #        #######
### ########## ############################ ######## #######
### ########## ############################ ######## #######
############## ############################ ######## #######
############## ############################ ######## #######
##############                              ######## #######
############## #############################################
############## #                                            
############## #############################################