### ########################################################
### ########################################################
### ########################################################
### ########################################################
### ########################################################
###                                    #####################
### ################################## #####################
###            ####################### #####################
############## ####################### #####################
##############                         #####################
#######          ###########################################
############## #############################################
############## #############################################
############## #############################################
############## #############################################
############## #############################################
############## #############################################
############## #############################################
############## #############################################
############## #############################################
##############                                        #     
############################################################